====================
=                  =
= ====== == ====== =
=      = == =      =
= =      ==      = =
= == === == === == =
=                  =
= = == ==  == == = =
= = =  =    =  = = =
= =   == == ==   = =
= ==   = == =   == =
= =  = =    = =  = =
= = == ==  == == = =
=                  =
= === == == == === =
= =      ==      = =
=      = == =      =
= ====== == ====== =
=                  =
====================