====================
=          =       =
====== === = =======
=        =         =
= ============== ===
=      ==          =
======  ============
== ==== == =========
=                  =
========= ==========
=         =        =
======= === ====== =
= = === === ========
=                  =
======== ========= =
=               == =
=============== =  =
=============== = ==
=               =  =
====================
