====================
= =      ==      = =
= = = = ==== = = = =
= = = =  ==  = = = =
= = = = ==== = = = =
=   = =  ==  = =   =
===== = ==== = =====
=     =  ==  =     =
======= ==== =======
= =              = =
=   ==== == ====   =
== == =  ==  = == ==
=     = ==== =     =
== == =  ==  = == ==
=   = == == == =   =
= = = =  ==  = = = =
= = = = ==== = = = =
= = = =  ==  = = = =
= = = == == == = = =
====================
